9
■■■■■■■■■■■■
■          ■
■          ■ 
■■■■■ ■■■ ■■
■          ■
■   ■  ■   ■
■          ■
■      @   ■
■■■■■■■■■■■■